{
    "structure": [
        "0000WWWWWWWWWWW0000",
        "0000WBFCCCCCFEW0000",
        "0000WFWCWCWCWFW0000",
        "0000WCCCCCCCCCW0000",
        "WWWWWCWCWCWCWCWWWWW",
        "WCCCCCCCCCCCCCCCCCW",
        "WCWCWCWCWEWCWCWCWCW",
        "WCCCCCCCCFCCCCCCCCW",
        "WCWCWCWCWFWCWCWCWCW",
        "WCCCCCFFFFFFECCCCCW",
        "WCWCWCWCWFWCWCWCWCW",
        "WCCCCCCCCFCCCCCCCCW",
        "WCWCWCWCWFWCWCWCWCW",
        "WCCCCCCCCCCCCCCCCCW",
        "WWWWWCWCWCWCWCWWWWW",
        "0000WCCCCCCCCCW0000",
        "0000WFWCWCWCWFW0000",
        "0000WRFCCCCCFYW0000",
        "0000WWWWWWWWWWW0000"
    ]
}