{
    "structure": [
        "WWWWWWWWWWWWWWWWWWWWWWWWW",
        "WBFCCCCCCCCCCCCCCCCCCCFEW",
        "WFWCWCWCWCWCWCWCWCWCWCWFW",
        "WCCCCCCCCCCCCCCCCCCCCCCCW",
        "WCWCWCWCWCWCWCWCWCWCWCWCW",
        "WCCCCCCCCCCFEFCCCCCCCCCCW",
        "WCWCWCWCWCWFWFWCWCWCWCWCW",
        "WCCCCCCCCCCFEFCCCCCCCCCCW",
        "WCWCWCWCWCWCCCWCWCWCWCWCW",
        "WCCCCCCCCCCCCCCCCCCCCCCCW",
        "WFWCWCWCWCWCWCWCWCWCWCWFW",
        "WRFCCCCCCCCCCCCCCCCCCCFYW",
        "WWWWWWWWWWWWWWWWWWWWWWWWW"
    ]
}