{
    "structure": [
        "WWWWWWWWWWWWWWWWWWWWWWWWW",
        "WBFCCCCCCCCCCCCCCCCCCCFEW",
        "WFWCWCWCWCWCWCWCWCWCWCWFW",
        "WCCCCCCCCCCCCCCCCCCCCCCCW",
        "WCWCWCWCWCWCWCWCWCWCWCWCW",
        "WCCCCCCCCCCFFECCCCCCCCCCW",
        "WCWCWCWCWCWFWFWCWCWCWCWCW",
        "WCCCCCCCCCCFFFCCCCCCCCCCW",
        "WCWCWCWCWCWCWCWCWCWCWCWCW",
        "WCCCCCCCCCCCCCCCCCCCCCCCW",
        "WFWCWCWCWCWCWCWCWCWCWCWFW",
        "WRFCCCCCCCCCCCCCCCCCCCFYW",
        "WWWWWWWWWWWWWWWWWWWWWWWWW"
    ]
}